$$$ exec p2 : [players/mperronc.filler]
Plateau 15 17:
    01234567890123456
000 .................
001 .ooo.............
002 OOOO.............
003 O................
004 OOO..............
005 O................
006 OOOO.............
007 .OO..............
008 OOOO.............
009 .................
010 .................
011 .................
012 ..............XXX
013 ......XXXXXXXXXXX
014 .....XX...XXXXXXX
Piece 2 3:
***
***
